1 1 0 0 255 150 1 0
2 2 0 0 255 150 1 0
3 3 0 0 255 150 1 0
4 4 0 0 255 150 1 0 
5 5 0 0 255 150 1 0 
6 6 0 0 255 150 1 0 
7 7 0 0 255 150 1 0 
8 8 0 0 255 150 1 0 
9 9 0 0 255 150 1 0 
9 10 0 0 255 150 1 0 
8 11 0 0 255 150 1 0 
7 12 0 0 255 150 1 0 
6 13 0 0 255 150 1 0 
5 14 0 0 255 150 1 0 
4 15 0 0 255 150 1 0 
3 16 0 0 255 150 1 0 
2 17 0 0 255 150 1 0 
1 18 0 0 255 150 1 0 
0 19 0 0 255 150 1 0 
10 9 0 0 255 150 1 0 
11 8 0 0 255 150 1 0 
12 7 0 0 255 150 1 0 
13 6 0 0 255 150 1 0 
14 5 0 0 255 150 1 0 
15 4 0 0 255 150 1 0 
16 3 0 0 255 150 1 0 
17 2 0 0 255 150 1 0 
18 1 0 0 255 150 1 0 
19 0 0 0 255 150 1 0 
10 10 0 0 255 150 1 0 
11 11 0 0 255 150 1 0 
12 12 0 0 255 150 1 0 
13 13 0 0 255 150 1 0 
14 14 0 0 255 150 1 0 
15 15 0 0 255 150 1 0 
16 16 0 0 255 150 1 0 
17 17 0 0 255 150 1 0 
18 18 0 0 255 150 1 0 
19 19 0 0 255 150 1 0 
0 0 255 0 0 150 2 0 
1 0 255 0 0 150 2 0 
2 0 255 0 0 150 2 0 
3 0 255 0 0 150 2 0 
4 0 255 0 0 150 2 0 
5 0 255 0 0 150 2 0 
6 0 255 0 0 150 2 0 
7 0 255 0 0 150 2 0
8 0 255 0 0 150 2 0 
9 0 255 0 0 150 2 0 
10 0 255 0 0 150 2 0 
11 0 255 0 0 150 2 0 
12 0 255 0 0 150 2 0 
13 0 255 0 0 150 2 0 
14 0 255 0 0 150 2 0 
15 0 255 0 0 150 2 0 
16 0 255 0 0 150 2 0 
17 0 255 0 0 150 2 0 
18 0 255 0 0 150 2 0 
19 0 255 0 0 150 2 0 