12 0 85 85 85 255 2 1
13 0 85 85 85 255 2 1

11 1 85 85 85 255 2 1
12 1 85 85 85 255 2 1
13 1 85 85 85 255 2 1

10 2 85 85 85 255 2 0
11 2 85 85 85 255 2 0
12 2 85 85 85 255 2 0
13 2 85 85 85 255 2 0
14 2 85 85 85 255 2 0

8 3 85 85 85 255 2 0
9 3 85 85 85 255 2 0
10 3 85 85 85 255 2 0
11 3 85 85 85 255 2 0
12 3 85 85 85 255 2 0
13 3 85 85 85 255 2 0
14 3 85 85 85 255 2 0
15 3 85 85 85 255 2 0

10 4 200 200 200 255 1 0
11 4 231 153 101 255 1 0
12 4 231 153 101 255 1 0
13 4 231 153 101 255 1 0
14 4 200 200 200 255 1 0

7 5 140 55 20 255 1 0
10 5 200 200 200 255 1 0
11 5 20 20 20 255 2 0
12 5 231 153 101 255 1 0
13 5 20 20 20 255 2 0
14 5 200 200 200 255 1 0

7 6 140 55 20 255 1 0
10 6 200 200 200 255 1 0
11 6 231 153 101 255 1 0
12 6 231 153 101 255 1 0
13 6 231 153 101 255 1 0
14 6 200 200 200 255 1 0

7 7 140 55 20 255 1 0
10 7 200 200 200 255 1 0
11 7 231 153 101 255 1 0
12 7 200 200 200 255 1 0
13 7 231 153 101 255 1 0
14 7 200 200 200 255 1 0

7 8 140 55 20 255 1 0
10 8 200 200 200 255 1 0
11 8 200 200 200 255 1 0
12 8 20 20 20 255 2 0
13 8 200 200 200 255 1 0
14 8 200 200 200 255 1 0

7 9 140 55 20 255 1 0
8 9 140 55 20 255 1 0
10 9 200 200 200 255 1 0
11 9 200 200 200 255 1 0
12 9 200 200 200 255 1 0
13 9 200 200 200 255 1 0
14 9 200 200 200 255 1 0

8 10 140 55 20 255 1 0
11 10 200 200 200 255 1 0
12 10 200 200 200 255 1 0
13 10 200 200 200 255 1 0

8 11 140 55 20 255 1 0
9 11 140 55 20 255 1 0
10 11 150 150 150 255 1 0
11 11 200 200 200 255 1 0
12 11 200 200 200 255 1 0
13 11 200 200 200 255 1 0
14 11 150 150 150 255 1 0

9 12 140 55 20 255 1 0
10 12 140 55 20 255 1 0
11 12 150 150 150 255 1 0
12 12 200 200 200 255 1 0
13 12 200 200 200 255 1 0
14 12 150 150 150 255 1 0

10 13 140 55 20 255 1 0
11 13 150 150 150 255 1 0
12 13 150 150 150 255 1 0
13 13 200 200 200 255 1 0
14 13 150 150 150 255 1 0

7 16 150 150 150 255 3 1
10 16 150 150 150 255 3 1
13 16 150 150 150 255 3 1
16 16 150 150 150 255 3 1
19 16 150 150 150 255 3 1