12 0 85 85 85 255 2 1
13 0 85 85 85 255 2 1

11 1 85 85 85 255 2 1
12 1 85 85 85 255 2 1
13 1 85 85 85 255 2 1

10 2 85 85 85 255 2 1
11 2 85 85 85 255 2 1
12 2 85 85 85 255 2 1
13 2 85 85 85 255 2 1
14 2 85 85 85 255 2 1

8 3 85 85 85 255 2 1
9 3 85 85 85 255 2 1
10 3 85 85 85 255 2 1
11 3 85 85 85 255 2 1
12 3 85 85 85 255 2 1
13 3 85 85 85 255 2 1
14 3 85 85 85 255 2 1
15 3 85 85 85 255 2 1

10 4 200 200 200 255 1 1
11 4 231 153 101 255 1 1
12 4 231 153 101 255 1 1
13 4 231 153 101 255 1 1
14 4 200 200 200 255 1 1

7 5 140 55 20 255 1 1
10 5 200 200 200 255 1 1
11 5 20 20 20 255 2 1
12 5 231 153 101 255 1 1
13 5 20 20 20 255 2 1
14 5 200 200 200 255 1 1

7 6 140 55 20 255 1 1
10 6 200 200 200 255 1 1
11 6 231 153 101 255 1 1
12 6 231 153 101 255 1 1
13 6 231 153 101 255 1 1
14 6 200 200 200 255 1 1

7 7 140 55 20 255 1 1
10 7 200 200 200 255 1 1
11 7 231 153 101 255 1 1
12 7 200 200 200 255 1 1
13 7 231 153 101 255 1 1
14 7 200 200 200 255 1 1

7 8 140 55 20 255 1 1
10 8 200 200 200 255 1 1
11 8 200 200 200 255 1 1
12 8 20 20 20 255 2 1
13 8 200 200 200 255 1 1
14 8 200 200 200 255 1 1

7 9 140 55 20 255 1 1
8 9 140 55 20 255 1 1
10 9 200 200 200 255 1 1
11 9 200 200 200 255 1 1
12 9 200 200 200 255 1 1
13 9 200 200 200 255 1 1
14 9 200 200 200 255 1 1

8 10 140 55 20 255 1 1
11 10 200 200 200 255 1 1
12 10 200 200 200 255 1 1
13 10 200 200 200 255 1 1

8 11 140 55 20 255 1 1
9 11 140 55 20 255 1 1
10 11 150 150 150 255 1 1
11 11 200 200 200 255 1 1
12 11 200 200 200 255 1 1
13 11 200 200 200 255 1 1
14 11 150 150 150 255 1 1

9 12 140 55 20 255 1 1
10 12 140 55 20 255 1 1
11 12 150 150 150 255 1 1
12 12 200 200 200 255 1 1
13 12 200 200 200 255 1 1
14 12 150 150 150 255 1 1

10 13 140 55 20 255 1 1
11 13 150 150 150 255 1 1
12 13 150 150 150 255 1 1
13 13 200 200 200 255 1 1
14 13 150 150 150 255 1 1

7 16 150 150 150 255 3 1
10 16 150 150 150 255 3 1
13 16 150 150 150 255 3 1
16 16 150 150 150 255 3 1
19 16 150 150 150 255 3 1